############
#         O#
#   P   ####
#          #
#######    #
# O  ##    #
#    ##    #
#          #
#       XX #
#       #  #
#          #
############
